;wykryte;nienaprawialne;niewykryte;bledy;;;;;;;;wykryte (posortowane);nienaprawialne;niewykryte;bledy
0;3473;182;4;3477;;1);;;;;;3387;159;5;3392
1;3537;170;2;3539;;;ŒREDNIA BLEDOW;;ODCH. BLEDOW;;;3399;167;6;3405
2;3602;169;3;3605;;;3567,48;;56,26;;;3411;197;5;3416
3;3538;180;1;3539;;;;;;;;3417;161;2;3419
4;3643;169;3;3646;;;ŒREDNIA WYKRYTYCH;;ODCH. WYKRYTYCH;;;3423;163;2;3425
5;3676;190;2;3678;;;3564,41;;56,29;;;3426;170;4;3430
6;3586;160;1;3587;;;;;;;;3422;196;9;3431
7;3439;196;1;3440;;;ŒREDNIA NIENAPRAWIALNYCH;;ODCH. NIENAPRAWIALNYCH;;;3427;166;7;3434
8;3565;173;4;3569;;;180,81;;13,62;;;3435;166;0;3435
9;3521;169;3;3524;;;;;;;;3433;172;2;3435
10;3552;170;2;3554;;;ŒREDNIA NIEWYKRYWALNYCH;;ODCH. NIEWYKRYTYCH;;;3437;173;2;3439
11;3501;179;2;3503;;;3,06;;1,78;;;3439;162;1;3440
12;3584;178;2;3586;;;;;;;;3439;196;1;3440
13;3562;189;2;3564;;;;;;;;3439;160;4;3443
14;3523;178;2;3525;;;;;;;;3439;152;5;3444
15;3437;173;2;3439;;;;;;;;3443;204;3;3446
16;3578;181;5;3583;;;;;;;1;3444;168;3;3447
17;3580;188;4;3584;3387;145;0;3392;min;;2;3446;171;3;3449
18;3571;168;2;3573;3527;178;3;3530;Q1;;3;3445;152;5;3450
19;3611;184;4;3615;3566;180;3;3569;mediana;;4;3448;163;3;3451
20;3570;186;7;3577;3599;183;3;3603;Q3;;5;3450;162;3;3453
21;3560;188;0;3560;3809;232;11;3814;max;;6;3456;172;0;3456
22;3532;156;2;3534;;;;;;;7;3452;176;4;3456
23;3619;178;7;3626;;;;;;;8;3455;200;2;3457
24;3538;182;6;3544;;;;;;;9;3456;178;3;3459
25;3556;196;7;3563;;;STATYSTYKA 5-punktowa;;;;10;3460;176;1;3461
26;3609;177;6;3615;;;;;;;11;3453;189;8;3461
27;3572;195;2;3574;;;BLEDY;;;;12;3461;176;1;3462
28;3542;174;0;3542;;;;;;;13;3458;177;4;3462
29;3538;182;0;3538;;;Q1;3392;;;14;3458;178;4;3462
30;3583;184;4;3587;;;Q2;3530;;;15;3457;160;5;3462
31;3530;167;4;3534;;;Q3;3569;;;16;3462;171;1;3463
32;3589;167;2;3591;;;Q4;3603;;;17;3461;159;2;3463
33;3469;171;3;3472;;;Q5;3814;;;18;3459;151;4;3463
34;3558;166;1;3559;;;;;;;19;3463;179;2;3465
35;3564;180;5;3569;;;WYKRYTE;;;;20;3463;156;3;3466
36;3809;232;5;3814;;;;;;;21;3463;195;3;3466
37;3508;161;4;3512;;;Q1;3387;;;22;3465;181;2;3467
38;3439;152;5;3444;;;Q2;3527;;;;3468;177;0;3468
39;3528;182;3;3531;;;Q3;3566;;;;3469;164;0;3469
40;3455;200;2;3457;;;Q4;3599;;;;3466;188;3;3469
41;3546;173;4;3550;;;Q5;3809;;;;3467;173;3;3470
42;3590;174;3;3593;;;;;;;;3463;179;7;3470
43;3599;185;2;3601;;;NIENAPRAWIALNE;;;;;3469;156;2;3471
44;3581;186;6;3587;;;;;;;;3471;165;1;3472
45;3550;178;0;3550;;;Q1;145;;;;3471;188;1;3472
46;3597;181;2;3599;;;Q2;178;;;;3469;166;3;3472
47;3511;175;2;3513;;;Q3;180;;;;3469;171;3;3472
48;3517;189;2;3519;;;Q4;183;;;;3469;175;3;3472
49;3476;197;4;3480;;;Q5;232;;;;3466;185;6;3472
50;3555;162;2;3557;;;;;;;;3472;165;1;3473
51;3582;181;2;3584;;;NIEWYKRYWALNE;;;;;3471;155;2;3473
52;3523;189;6;3529;;;;;;;;3465;161;8;3473
53;3629;204;6;3635;;;Q1;0;;;;3472;172;3;3475
54;3637;181;2;3639;;;Q2;3;;;;3473;166;3;3476
55;3512;172;7;3519;;;Q3;3;;;;3473;182;4;3477
56;3597;189;2;3599;;;Q4;3;;;;3477;191;1;3478
57;3665;202;3;3668;;;Q5;11;;;;3474;181;4;3478
58;3494;179;3;3497;;;;;;;;3479;177;0;3479
59;3521;179;2;3523;;;;;;;;3480;154;0;3480
60;3631;209;2;3633;;;;;;;;3480;168;0;3480
61;3496;193;4;3500;;;;;;;;3476;194;4;3480
62;3593;188;2;3595;;;;;;;;3476;197;4;3480
63;3624;193;4;3628;;;;;;;;3473;180;7;3480
64;3603;180;4;3607;;;;;;;;3478;196;3;3481
65;3514;158;2;3516;;;;;;;;3474;169;7;3481
66;3588;189;1;3589;;;;;;;;3481;190;1;3482
67;3567;165;5;3572;;;;;;;;3480;176;2;3482
68;3651;208;5;3656;;;;;;;;3480;183;3;3483
69;3558;185;3;3561;;;;;;;;3479;180;4;3483
70;3519;165;3;3522;;;;;;;;3483;169;3;3486
71;3493;174;3;3496;;;;;;;;3481;182;5;3486
72;3575;187;3;3578;;;;;;;;3485;185;2;3487
73;3579;196;5;3584;;;;;;;;3483;182;4;3487
74;3660;186;1;3661;;;;;;;;3481;191;6;3487
75;3633;193;6;3639;;;;;;;;3486;167;2;3488
76;3471;165;1;3472;;;;;;;;3486;180;2;3488
77;3609;183;2;3611;;;;;;;;3485;182;3;3488
78;3599;171;5;3604;;;;;;;;3484;193;4;3488
79;3671;183;5;3676;;;;;;;;3483;180;5;3488
80;3578;176;4;3582;;;;;;;;3488;164;1;3489
81;3565;181;1;3566;;;;;;;;3487;154;2;3489
82;3546;183;6;3552;;;;;;;;3485;173;4;3489
83;3629;211;4;3633;;;;;;;;3484;179;5;3489
84;3589;187;5;3594;;;;;;;;3486;178;4;3490
85;3599;208;3;3602;;;;;;;;3490;163;1;3491
86;3510;184;6;3516;;;;;;;;3489;169;2;3491
87;3630;205;7;3637;;;;;;;;3492;190;0;3492
88;3498;192;4;3502;;;;;;;;3490;180;2;3492
89;3529;193;2;3531;;;;;;;;3485;179;7;3492
90;3639;174;2;3641;;;;;;;;3492;206;1;3493
91;3483;180;5;3488;;;;;;;;3491;166;2;3493
92;3574;164;3;3577;;;;;;;;3491;196;2;3493
93;3645;180;5;3650;;;;;;;;3491;163;3;3494
94;3571;161;2;3573;;;;;;;;3491;179;3;3494
95;3505;172;2;3507;;;;;;;;3490;180;4;3494
96;3590;171;1;3591;;;;;;;;3494;187;1;3495
97;3523;201;5;3528;;;;;;;;3491;173;4;3495
98;3569;164;1;3570;;;;;;;;3495;150;1;3496
99;3567;183;3;3570;;;;;;;;3493;174;3;3496
100;3519;177;6;3525;;;;;;;;3493;184;3;3496
101;3590;182;6;3596;;;;;;;;3492;160;4;3496
102;3573;180;3;3576;;;;;;;;3491;199;5;3496
103;3559;204;4;3563;;;;;;;;3494;176;3;3497
104;3573;168;1;3574;;;;;;;;3494;179;3;3497
105;3657;200;5;3662;;;;;;;;3494;185;3;3497
106;3587;161;2;3589;;;;;;;;3493;181;4;3497
107;3523;165;2;3525;;;;;;;;3492;166;5;3497
108;3516;171;3;3519;;;;;;;;3498;145;0;3498
109;3597;196;1;3598;;;;;;;;3497;169;1;3498
110;3543;189;4;3547;;;;;;;;3497;176;1;3498
111;3486;180;2;3488;;;;;;;;3496;169;2;3498
112;3544;153;1;3545;;;;;;;;3495;175;3;3498
113;3509;193;1;3510;;;;;;;;3494;179;4;3498
114;3502;190;2;3504;;;;;;;;3496;169;3;3499
115;3664;172;3;3667;;;;;;;;3496;196;3;3499
116;3612;181;3;3615;;;;;;;;3498;165;2;3500
117;3586;168;4;3590;;;;;;;;3498;172;2;3500
118;3561;191;6;3567;;;;;;;;3498;172;2;3500
119;3500;175;2;3502;;;;;;;;3496;187;4;3500
120;3576;186;1;3577;;;;;;;;3496;192;4;3500
121;3578;180;3;3581;;;;;;;;3496;193;4;3500
122;3577;174;5;3582;;;;;;;;3501;165;0;3501
123;3530;173;5;3535;;;;;;;;3499;169;2;3501
124;3605;170;1;3606;;;;;;;;3500;175;2;3502
125;3612;177;5;3617;;;;;;;;3500;183;2;3502
126;3387;159;5;3392;;;;;;;;3499;162;3;3502
127;3556;178;3;3559;;;;;;;;3499;172;3;3502
128;3498;172;2;3500;;;;;;;;3498;192;4;3502
129;3661;195;4;3665;;;;;;;;3497;200;5;3502
130;3551;172;3;3554;;;;;;;;3496;188;6;3502
131;3494;187;1;3495;;;;;;;;3501;179;2;3503
132;3538;186;1;3539;;;;;;;;3500;163;3;3503
133;3666;169;2;3668;;;;;;;;3499;175;4;3503
134;3563;164;1;3564;;;;;;;;3497;176;6;3503
135;3629;172;1;3630;;;;;;;;3502;190;2;3504
136;3582;172;2;3584;;;;;;;;3497;168;7;3504
137;3602;189;1;3603;;;;;;;;3505;158;0;3505
138;3516;168;6;3522;;;;;;;;3501;174;4;3505
139;3559;173;1;3560;;;;;;;;3497;185;8;3505
140;3565;176;1;3566;;;;;;;;3506;186;0;3506
141;3494;176;3;3497;;;;;;;;3505;172;1;3506
142;3543;186;2;3545;;;;;;;;3504;185;2;3506
143;3583;188;2;3585;;;;;;;;3501;165;5;3506
144;3523;183;3;3526;;;;;;;;3501;187;5;3506
145;3510;159;3;3513;;;;;;;;3505;153;2;3507
146;3577;187;7;3584;;;;;;;;3505;172;2;3507
147;3633;188;3;3636;;;;;;;;3504;199;3;3507
148;3624;191;3;3627;;;;;;;;3503;176;4;3507
149;3672;184;4;3676;;;;;;;;3502;192;5;3507
150;3655;193;3;3658;;;;;;;;3505;194;3;3508
151;3500;163;3;3503;;;;;;;;3507;167;2;3509
152;3573;166;2;3575;;;;;;;;3506;182;3;3509
153;3526;197;4;3530;;;;;;;;3503;201;6;3509
154;3555;193;3;3558;;;;;;;;3509;193;1;3510
155;3657;200;3;3660;;;;;;;;3509;197;1;3510
156;3549;177;6;3555;;;;;;;;3507;179;3;3510
157;3557;169;3;3560;;;;;;;;3509;186;3;3512
158;3622;190;2;3624;;;;;;;;3508;161;4;3512
159;3523;174;4;3527;;;;;;;;3507;164;5;3512
160;3568;176;2;3570;;;;;;;;3512;180;1;3513
161;3585;161;2;3587;;;;;;;;3511;175;2;3513
162;3573;175;2;3575;;;;;;;;3510;159;3;3513
163;3472;165;1;3473;;;;;;;;3509;154;4;3513
164;3544;170;5;3549;;;;;;;;3513;205;1;3514
165;3657;177;5;3662;;;;;;;;3512;167;2;3514
166;3606;201;4;3610;;;;;;;;3511;157;3;3514
167;3578;183;3;3581;;;;;;;;3509;182;5;3514
168;3602;206;2;3604;;;;;;;;3508;191;6;3514
169;3612;185;2;3614;;;;;;;;3514;182;1;3515
170;3752;193;1;3753;;;;;;;;3514;182;1;3515
171;3608;198;4;3612;;;;;;;;3514;197;1;3515
172;3590;183;0;3590;;;;;;;;3513;176;2;3515
173;3471;155;2;3473;;;;;;;;3514;158;2;3516
174;3633;191;2;3635;;;;;;;;3513;174;3;3516
175;3517;168;2;3519;;;;;;;;3510;184;6;3516
176;3506;186;0;3506;;;;;;;;3509;183;7;3516
177;3525;171;3;3528;;;;;;;;3515;170;2;3517
178;3536;171;6;3542;;;;;;;;3515;173;2;3517
179;3540;151;3;3543;;;;;;;;3515;176;2;3517
180;3559;169;4;3563;;;;;;;;3515;187;2;3517
181;3512;167;2;3514;;;;;;;;3513;184;4;3517
182;3491;196;2;3493;;;;;;;;3516;175;2;3518
183;3551;169;4;3555;;;;;;;;3513;172;5;3518
184;3523;198;2;3525;;;;;;;;3518;175;1;3519
185;3642;180;4;3646;;;;;;;;3517;168;2;3519
186;3712;184;0;3712;;;;;;;;3517;189;2;3519
187;3479;180;4;3483;;;;;;;;3516;171;3;3519
188;3548;169;7;3555;;;;;;;;3512;172;7;3519
189;3641;183;1;3642;;;;;;;;3519;173;1;3520
190;3676;198;3;3679;;;;;;;;3517;167;3;3520
191;3546;167;1;3547;;;;;;;;3512;168;8;3520
192;3498;165;2;3500;;;;;;;;3520;177;1;3521
193;3601;180;0;3601;;;;;;;;3520;183;1;3521
194;3553;190;3;3556;;;;;;;;3519;188;2;3521
195;3561;186;6;3567;;;;;;;;3519;198;2;3521
196;3582;184;5;3587;;;;;;;;3518;189;3;3521
197;3513;186;8;3521;;;;;;;;3517;187;4;3521
198;3581;194;11;3592;;;;;;;;3513;186;8;3521
199;3493;184;3;3496;;;;;;;;3520;168;2;3522
200;3590;176;1;3591;;;;;;;;3519;165;3;3522
201;3492;206;1;3493;;;;;;;;3519;172;3;3522
202;3581;198;0;3581;;;;;;;;3519;181;3;3522
203;3616;173;1;3617;;;;;;;;3518;174;4;3522
204;3560;188;2;3562;;;;;;;;3517;187;5;3522
205;3496;187;4;3500;;;;;;;;3516;168;6;3522
206;3469;164;0;3469;;;;;;;;3522;173;1;3523
207;3670;154;1;3671;;;;;;;;3522;191;1;3523
208;3578;180;2;3580;;;;;;;;3521;179;2;3523
209;3556;191;4;3560;;;;;;;;3521;192;2;3523
210;3658;154;4;3662;;;;;;;;3521;169;3;3524
211;3579;180;2;3581;;;;;;;;3520;166;4;3524
212;3577;160;1;3578;;;;;;;;3520;166;4;3524
213;3586;187;6;3592;;;;;;;;3520;177;4;3524
214;3504;199;3;3507;;;;;;;;3520;198;4;3524
215;3600;174;1;3601;;;;;;;;3523;165;2;3525
216;3520;198;4;3524;;;;;;;;3523;178;2;3525
217;3513;184;4;3517;;;;;;;;3523;198;2;3525
218;3480;183;3;3483;;;;;;;;3522;173;3;3525
219;3529;190;5;3534;;;;;;;;3521;159;4;3525
220;3573;169;4;3577;;;;;;;;3519;177;6;3525
221;3650;197;1;3651;;;;;;;;3517;202;8;3525
222;3560;211;3;3563;;;;;;;;3525;182;1;3526
223;3480;176;2;3482;;;;;;;;3525;201;1;3526
224;3541;185;8;3549;;;;;;;;3524;156;2;3526
225;3582;187;3;3585;;;;;;;;3523;183;3;3526
226;3587;190;4;3591;;;;;;;;3523;192;3;3526
227;3593;187;4;3597;;;;;;;;3521;162;5;3526
228;3522;173;3;3525;;;;;;;;3526;193;1;3527
229;3609;179;3;3612;;;;;;;;3525;179;2;3527
230;3548;188;5;3553;;;;;;;;3523;174;4;3527
231;3561;180;3;3564;;;;;;;;3526;183;2;3528
232;3508;191;6;3514;;;;;;;;3525;170;3;3528
233;3567;176;1;3568;;;;;;;;3525;171;3;3528
234;3445;152;5;3450;;;;;;;;3524;198;4;3528
235;3650;192;3;3653;;;;;;;;3523;201;5;3528
236;3546;159;1;3547;;;;;;;;3528;170;1;3529
237;3535;175;4;3539;;;;;;;;3527;169;2;3529
238;3636;174;4;3640;;;;;;;;3527;196;2;3529
239;3651;191;3;3654;;;;;;;;3527;205;2;3529
240;3554;163;2;3556;;;;;;;;3526;167;3;3529
241;3590;171;2;3592;;;;;;;;3526;194;3;3529
242;3654;198;1;3655;;;;;;;;3526;205;3;3529
243;3499;172;3;3502;;;;;;;;3525;166;4;3529
244;3584;186;1;3585;;;;;;;;3523;189;6;3529
245;3621;195;2;3623;;;;;;;;3529;174;1;3530
246;3568;188;2;3570;;;;;;;;3528;182;2;3530
247;3665;166;3;3668;;;;;;;;3527;180;3;3530
248;3491;179;3;3494;;;;;;;;3527;192;3;3530
249;3603;183;2;3605;;;;;;;;3526;197;4;3530
250;3526;194;3;3529;;;;;;;;3525;161;5;3530
251;3597;188;3;3600;;;;;;;;3525;180;5;3530
252;3600;165;0;3600;;;;;;;;3531;169;0;3531
253;3541;180;4;3545;;;;;;;;3529;193;2;3531
254;3614;183;4;3618;;;;;;;;3528;182;3;3531
255;3472;172;3;3475;;;;;;;;3531;159;1;3532
256;3719;179;3;3722;;;;;;;;3531;184;1;3532
257;3613;162;1;3614;;;;;;;;3530;177;2;3532
258;3554;175;6;3560;;;;;;;;3530;185;2;3532
259;3522;191;1;3523;;;;;;;;3529;179;3;3532
260;3457;160;5;3462;;;;;;;;3529;194;3;3532
261;3537;170;2;3539;;;;;;;;3529;197;3;3532
262;3571;195;3;3574;;;;;;;;3528;162;4;3532
263;3497;185;8;3505;;;;;;;;3527;172;5;3532
264;3569;173;2;3571;;;;;;;;3527;174;5;3532
265;3591;177;5;3596;;;;;;;;3527;190;5;3532
266;3517;167;3;3520;;;;;;;;3530;163;3;3533
267;3606;172;4;3610;;;;;;;;3530;167;3;3533
268;3574;155;2;3576;;;;;;;;3532;156;2;3534
269;3640;184;5;3645;;;;;;;;3532;180;2;3534
270;3551;164;2;3553;;;;;;;;3532;189;2;3534
271;3662;192;3;3665;;;;;;;;3530;167;4;3534
272;3543;179;4;3547;;;;;;;;3530;177;4;3534
273;3631;154;1;3632;;;;;;;;3529;184;5;3534
274;3435;166;0;3435;;;;;;;;3529;190;5;3534
275;3518;189;3;3521;;;;;;;;3529;200;5;3534
276;3546;181;3;3549;;;;;;;;3534;185;1;3535
277;3586;195;3;3589;;;;;;;;3530;173;5;3535
278;3499;162;3;3502;;;;;;;;3529;183;6;3535
279;3565;189;2;3567;;;;;;;;3529;198;6;3535
280;3626;183;2;3628;;;;;;;;3533;168;3;3536
281;3542;192;3;3545;;;;;;;;3533;175;3;3536
282;3616;196;2;3618;;;;;;;;3533;176;3;3536
283;3571;153;4;3575;;;;;;;;3532;176;4;3536
284;3562;183;5;3567;;;;;;;;3532;184;4;3536
285;3587;170;1;3588;;;;;;;;3530;164;6;3536
286;3555;158;0;3555;;;;;;;;3529;170;7;3536
287;3529;184;5;3534;;;;;;;;3536;191;1;3537
288;3586;180;5;3591;;;;;;;;3535;151;2;3537
289;3566;193;2;3568;;;;;;;;3534;167;3;3537
290;3575;187;2;3577;;;;;;;;3534;189;3;3537
291;3540;179;3;3543;;;;;;;;3538;182;0;3538
292;3604;193;5;3609;;;;;;;;3536;186;2;3538
293;3610;183;3;3613;;;;;;;;3535;168;3;3538
294;3549;164;2;3551;;;;;;;;3534;200;4;3538
295;3638;175;3;3641;;;;;;;;3533;196;5;3538
296;3612;180;0;3612;;;;;;;;3532;163;6;3538
297;3534;167;3;3537;;;;;;;;3538;180;1;3539
298;3586;185;1;3587;;;;;;;;3538;186;1;3539
299;3583;169;2;3585;;;;;;;;3537;170;2;3539
300;3561;176;4;3565;;;;;;;;3537;170;2;3539
301;3501;187;5;3506;;;;;;;;3537;186;2;3539
302;3608;185;2;3610;;;;;;;;3536;173;3;3539
303;3528;170;1;3529;;;;;;;;3536;179;3;3539
304;3677;181;3;3680;;;;;;;;3535;175;4;3539
305;3606;172;3;3609;;;;;;;;3534;182;5;3539
306;3686;165;3;3689;;;;;;;;3534;210;5;3539
307;3676;176;3;3679;;;;;;;;3539;178;1;3540
308;3568;167;5;3573;;;;;;;;3539;186;1;3540
309;3563;184;5;3568;;;;;;;;3537;175;3;3540
310;3648;166;2;3650;;;;;;;;3537;185;3;3540
311;3574;183;2;3576;;;;;;;;3536;162;4;3540
312;3575;189;3;3578;;;;;;;;3536;186;4;3540
313;3604;184;2;3606;;;;;;;;3533;198;7;3540
314;3772;168;1;3773;;;;;;;;3540;159;1;3541
315;3585;186;2;3587;;;;;;;;3540;172;1;3541
316;3578;189;5;3583;;;;;;;;3540;185;1;3541
317;3538;169;3;3541;;;;;;;;3539;185;2;3541
318;3590;181;3;3593;;;;;;;;3538;158;3;3541
319;3543;195;3;3546;;;;;;;;3538;166;3;3541
320;3588;177;4;3592;;;;;;;;3538;169;3;3541
321;3527;192;3;3530;;;;;;;;3538;182;3;3541
322;3520;168;2;3522;;;;;;;;3538;186;3;3541
323;3529;200;5;3534;;;;;;;;3537;190;4;3541
324;3466;185;6;3472;;;;;;;;3542;174;0;3542
325;3485;179;7;3492;;;;;;;;3539;184;3;3542
326;3566;167;1;3567;;;;;;;;3536;163;6;3542
327;3552;177;1;3553;;;;;;;;3536;171;6;3542
328;3623;167;2;3625;;;;;;;;3542;202;1;3543
329;3544;196;5;3549;;;;;;;;3540;151;3;3543
330;3488;164;1;3489;;;;;;;;3540;179;3;3543
331;3483;182;4;3487;;;;;;;;3541;185;3;3544
332;3590;188;4;3594;;;;;;;;3540;191;4;3544
333;3572;184;3;3575;;;;;;;;3540;227;4;3544
334;3629;173;1;3630;;;;;;;;3538;182;6;3544
335;3587;188;7;3594;;;;;;;;3545;190;0;3545
336;3586;172;4;3590;;;;;;;;3544;153;1;3545
337;3588;173;0;3588;;;;;;;;3543;186;2;3545
338;3568;187;3;3571;;;;;;;;3542;181;3;3545
339;3505;194;3;3508;;;;;;;;3542;192;3;3545
340;3529;198;6;3535;;;;;;;;3541;178;4;3545
341;3582;187;3;3585;;;;;;;;3541;180;4;3545
342;3632;195;4;3636;;;;;;;;3540;187;5;3545
343;3592;171;3;3595;;;;;;;;3545;187;1;3546
344;3580;162;3;3583;;;;;;;;3544;166;2;3546
345;3521;159;4;3525;;;;;;;;3544;187;2;3546
346;3601;199;3;3604;;;;;;;;3543;169;3;3546
347;3530;185;2;3532;;;;;;;;3543;171;3;3546
348;3517;187;4;3521;;;;;;;;3543;185;3;3546
349;3474;181;4;3478;;;;;;;;3543;195;3;3546
350;3576;177;4;3580;;;;;;;;3542;197;4;3546
351;3592;191;5;3597;;;;;;;;3542;202;4;3546
352;3632;195;6;3638;;;;;;;;3540;186;6;3546
353;3471;188;1;3472;;;;;;;;3546;159;1;3547
354;3545;209;2;3547;;;;;;;;3546;167;1;3547
355;3492;190;0;3492;;;;;;;;3545;209;2;3547
356;3485;182;3;3488;;;;;;;;3543;179;4;3547
357;3540;159;1;3541;;;;;;;;3543;189;4;3547
358;3467;173;3;3470;;;;;;;;3542;184;5;3547
359;3606;196;2;3608;;;;;;;;3547;179;1;3548
360;3659;194;4;3663;;;;;;;;3546;170;2;3548
361;3555;160;1;3556;;;;;;;;3545;170;3;3548
362;3573;192;2;3575;;;;;;;;3545;190;3;3548
363;3458;178;4;3462;;;;;;;;3545;192;3;3548
364;3573;176;1;3574;;;;;;;;3542;169;6;3548
365;3541;178;4;3545;;;;;;;;3539;186;9;3548
366;3589;168;1;3590;;;;;;;;3548;188;1;3549
367;3530;164;6;3536;;;;;;;;3547;167;2;3549
368;3619;196;0;3619;;;;;;;;3546;181;3;3549
369;3651;194;1;3652;;;;;;;;3545;174;4;3549
370;3530;177;4;3534;;;;;;;;3545;182;4;3549
371;3568;181;4;3572;;;;;;;;3544;170;5;3549
372;3609;196;7;3616;;;;;;;;3544;196;5;3549
373;3599;213;4;3603;;;;;;;;3541;185;8;3549
374;3583;186;4;3587;;;;;;;;3550;178;0;3550
375;3621;189;5;3626;;;;;;;;3546;173;4;3550
376;3545;187;1;3546;;;;;;;;3545;195;5;3550
377;3613;171;2;3615;;;;;;;;3544;182;6;3550
378;3555;176;3;3558;;;;;;;;3551;200;0;3551
379;3495;175;3;3498;;;;;;;;3549;164;2;3551
380;3568;204;0;3568;;;;;;;;3549;168;2;3551
381;3611;198;2;3613;;;;;;;;3549;177;2;3551
382;3517;202;8;3525;;;;;;;;3548;166;3;3551
383;3491;173;4;3495;;;;;;;;3550;181;2;3552
384;3527;172;5;3532;;;;;;;;3550;190;2;3552
385;3519;181;3;3522;;;;;;;;3549;197;3;3552
386;3518;175;1;3519;;;;;;;;3546;180;6;3552
387;3517;187;5;3522;;;;;;;;3546;183;6;3552
388;3539;178;1;3540;;;;;;;;3552;171;1;3553
389;3422;196;9;3431;;;;;;;;3552;177;1;3553
390;3631;181;2;3633;;;;;;;;3552;177;1;3553
391;3557;192;3;3560;;;;;;;;3551;161;2;3553
392;3466;188;3;3469;;;;;;;;3551;164;2;3553
393;3525;166;4;3529;;;;;;;;3551;210;2;3553
394;3701;197;8;3709;;;;;;;;3548;188;5;3553
395;3520;183;1;3521;;;;;;;;3553;158;1;3554
396;3534;210;5;3539;;;;;;;;3552;158;2;3554
397;3524;198;4;3528;;;;;;;;3552;170;2;3554
398;3506;182;3;3509;;;;;;;;3551;172;3;3554
399;3589;179;3;3592;;;;;;;;3551;192;3;3554
400;3667;173;2;3669;;;;;;;;3549;166;5;3554
401;3613;182;4;3617;;;;;;;;3549;182;5;3554
402;3533;175;3;3536;;;;;;;;3555;158;0;3555
403;3564;188;5;3569;;;;;;;;3554;206;1;3555
404;3505;172;1;3506;;;;;;;;3553;171;2;3555
405;3600;167;1;3601;;;;;;;;3553;203;2;3555
406;3606;199;7;3613;;;;;;;;3551;169;4;3555
407;3540;187;5;3545;;;;;;;;3551;195;4;3555
408;3628;194;1;3629;;;;;;;;3550;175;5;3555
409;3594;197;3;3597;;;;;;;;3549;177;6;3555
410;3456;178;3;3459;;;;;;;;3548;169;7;3555
411;3461;176;1;3462;;;;;;;;3555;160;1;3556
412;3616;190;4;3620;;;;;;;;3554;163;2;3556
413;3529;183;6;3535;;;;;;;;3554;185;2;3556
414;3584;163;4;3588;;;;;;;;3553;189;3;3556
415;3659;182;4;3663;;;;;;;;3553;190;3;3556
416;3594;167;2;3596;;;;;;;;3555;162;2;3557
417;3592;180;7;3599;;;;;;;;3554;189;3;3557
418;3560;197;3;3563;;;;;;;;3553;189;4;3557
419;3509;197;1;3510;;;;;;;;3557;177;1;3558
420;3556;165;3;3559;;;;;;;;3556;168;2;3558
421;3525;182;1;3526;;;;;;;;3555;176;3;3558
422;3571;175;1;3572;;;;;;;;3555;193;3;3558
423;3527;180;3;3530;;;;;;;;3554;209;4;3558
424;3497;169;1;3498;;;;;;;;3558;166;1;3559
425;3486;167;2;3488;;;;;;;;3558;194;1;3559
426;3587;188;4;3591;;;;;;;;3557;177;2;3559
427;3537;186;2;3539;;;;;;;;3557;178;2;3559
428;3567;186;0;3567;;;;;;;;3556;165;3;3559
429;3729;191;2;3731;;;;;;;;3556;178;3;3559
430;3439;160;4;3443;;;;;;;;3556;192;3;3559
431;3525;179;2;3527;;;;;;;;3560;188;0;3560
432;3618;170;1;3619;;;;;;;;3559;171;1;3560
433;3599;183;4;3603;;;;;;;;3559;173;1;3560
434;3513;172;5;3518;;;;;;;;3559;175;1;3560
435;3559;176;2;3561;;;;;;;;3557;169;3;3560
436;3499;175;4;3503;;;;;;;;3557;189;3;3560
437;3489;169;2;3491;;;;;;;;3557;192;3;3560
438;3537;185;3;3540;;;;;;;;3557;195;3;3560
439;3587;150;1;3588;;;;;;;;3556;171;4;3560
440;3560;180;4;3564;;;;;;;;3556;175;4;3560
441;3567;193;3;3570;;;;;;;;3556;191;4;3560
442;3551;192;3;3554;;;;;;;;3554;175;6;3560
443;3463;195;3;3466;;;;;;;;3560;171;1;3561
444;3618;203;1;3619;;;;;;;;3559;176;2;3561
445;3417;161;2;3419;;;;;;;;3558;168;3;3561
446;3577;176;0;3577;;;;;;;;3558;172;3;3561
447;3618;189;3;3621;;;;;;;;3558;185;3;3561
448;3602;190;2;3604;;;;;;;;3555;180;6;3561
449;3616;192;4;3620;;;;;;;;3561;147;1;3562
450;3556;175;4;3560;;;;;;;;3560;162;2;3562
451;3575;188;0;3575;;;;;;;;3560;188;2;3562
452;3643;176;2;3645;;;;;;;;3559;163;3;3562
453;3574;179;3;3577;;;;;;;;3558;196;4;3562
454;3487;154;2;3489;;;;;;;;3561;168;2;3563
455;3602;176;5;3607;;;;;;;;3560;197;3;3563
456;3591;173;0;3591;;;;;;;;3560;211;3;3563
457;3606;148;5;3611;;;;;;;;3559;156;4;3563
458;3533;168;3;3536;;;;;;;;3559;169;4;3563
459;3554;209;4;3558;;;;;;;;3559;204;4;3563
460;3640;168;2;3642;;;;;;;;3556;196;7;3563
461;3503;201;6;3509;;;;;;;;3563;164;1;3564
462;3507;179;3;3510;;;;;;;;3563;186;1;3564
463;3530;167;3;3533;;;;;;;;3562;189;2;3564
464;3594;200;1;3595;;;;;;;;3561;156;3;3564
465;3497;200;5;3502;;;;;;;;3561;180;3;3564
466;3560;187;4;3564;;;;;;;;3561;192;3;3564
467;3520;177;4;3524;;;;;;;;3560;180;4;3564
468;3531;184;1;3532;;;;;;;;3560;187;4;3564
469;3534;185;1;3535;;;;;;;;3560;192;4;3564
470;3480;168;0;3480;;;;;;;;3559;178;5;3564
471;3552;171;1;3553;;;;;;;;3559;180;5;3564
472;3572;176;2;3574;;;;;;;;3563;204;2;3565
473;3597;181;2;3599;;;;;;;;3561;176;4;3565
474;3535;168;3;3538;;;;;;;;3560;184;5;3565
475;3491;163;3;3494;;;;;;;;3565;176;1;3566
476;3551;161;2;3553;;;;;;;;3565;181;1;3566
477;3605;183;2;3607;;;;;;;;3565;190;1;3566
478;3521;162;5;3526;;;;;;;;3564;177;2;3566
479;3536;179;3;3539;;;;;;;;3564;187;2;3566
480;3635;211;7;3642;;;;;;;;3563;199;3;3566
481;3620;182;4;3624;;;;;;;;3557;170;9;3566
482;3569;178;3;3572;;;;;;;;3567;186;0;3567
483;3540;227;4;3544;;;;;;;;3566;167;1;3567
484;3580;176;2;3582;;;;;;;;3566;167;1;3567
485;3501;174;4;3505;;;;;;;;3565;189;2;3567
486;3569;170;5;3574;;;;;;;;3565;196;2;3567
487;3519;172;3;3522;;;;;;;;3562;183;5;3567
488;3580;194;3;3583;;;;;;;;3561;186;6;3567
489;3575;183;4;3579;;;;;;;;3561;191;6;3567
490;3561;147;1;3562;;;;;;;;3568;204;0;3568
491;3542;197;4;3546;;;;;;;;3567;176;1;3568
492;3498;172;2;3500;;;;;;;;3566;193;2;3568
493;3539;185;2;3541;;;;;;;;3565;178;3;3568
494;3587;209;2;3589;;;;;;;;3563;180;5;3568
495;3540;185;1;3541;;;;;;;;3563;184;5;3568
496;3542;184;5;3547;;;;;;;;3568;180;1;3569
497;3557;189;3;3560;;;;;;;;3567;156;2;3569
498;3599;182;4;3603;;;;;;;;3567;161;2;3569
499;3566;191;5;3571;;;;;;;;3565;173;4;3569
500;3509;154;4;3513;;;;;;;;3564;180;5;3569
501;3559;156;4;3563;;;;;;;;3564;188;5;3569
502;3529;174;1;3530;;;;;;;;3569;164;1;3570
503;3463;179;7;3470;;;;;;;;3568;174;2;3570
504;3547;167;2;3549;;;;;;;;3568;176;2;3570
505;3526;167;3;3529;;;;;;;;3568;188;2;3570
506;3633;181;2;3635;;;;;;;;3568;195;2;3570
507;3446;171;3;3449;;;;;;;;3567;151;3;3570
508;3591;183;5;3596;;;;;;;;3567;166;3;3570
509;3496;192;4;3500;;;;;;;;3567;183;3;3570
510;3569;200;7;3576;;;;;;;;3567;193;3;3570
511;3622;179;3;3625;;;;;;;;3567;203;3;3570
512;3584;170;1;3585;;;;;;;;3565;167;5;3570
513;3539;184;3;3542;;;;;;;;3565;188;5;3570
514;3560;184;5;3565;;;;;;;;3570;175;1;3571
515;3614;163;3;3617;;;;;;;;3569;173;2;3571
516;3615;210;3;3618;;;;;;;;3569;193;2;3571
517;3617;195;2;3619;;;;;;;;3568;187;3;3571
518;3620;181;4;3624;;;;;;;;3566;191;5;3571
519;3481;191;6;3487;;;;;;;;3565;171;6;3571
520;3544;187;2;3546;;;;;;;;3563;184;8;3571
521;3493;181;4;3497;;;;;;;;3571;175;1;3572
522;3532;189;2;3534;;;;;;;;3570;170;2;3572
523;3545;190;3;3548;;;;;;;;3570;183;2;3572
524;3646;215;3;3649;;;;;;;;3570;188;2;3572
525;3528;162;4;3532;;;;;;;;3569;175;3;3572
526;3567;151;3;3570;;;;;;;;3569;178;3;3572
527;3526;193;1;3527;;;;;;;;3569;187;3;3572
528;3590;186;5;3595;;;;;;;;3569;189;3;3572
529;3577;179;2;3579;;;;;;;;3568;181;4;3572
530;3526;205;3;3529;;;;;;;;3567;165;5;3572
531;3539;186;9;3548;;;;;;;;3566;171;6;3572
532;3553;189;4;3557;;;;;;;;3566;197;6;3572
533;3515;176;2;3517;;;;;;;;3571;161;2;3573
534;3550;190;2;3552;;;;;;;;3571;168;2;3573
535;3496;169;3;3499;;;;;;;;3571;177;2;3573
536;3608;226;1;3609;;;;;;;;3571;188;2;3573
537;3573;184;1;3574;;;;;;;;3570;188;3;3573
538;3497;176;6;3503;;;;;;;;3569;173;4;3573
539;3484;179;5;3489;;;;;;;;3568;167;5;3573
540;3589;191;7;3596;;;;;;;;3573;168;1;3574
541;3537;175;3;3540;;;;;;;;3573;176;1;3574
542;3620;178;7;3627;;;;;;;;3573;184;1;3574
543;3568;195;2;3570;;;;;;;;3573;194;1;3574
544;3595;171;1;3596;;;;;;;;3572;176;2;3574
545;3654;164;6;3660;;;;;;;;3572;179;2;3574
546;3578;153;8;3586;;;;;;;;3572;195;2;3574
547;3483;169;3;3486;;;;;;;;3571;195;3;3574
548;3433;172;2;3435;;;;;;;;3569;170;5;3574
549;3452;176;4;3456;;;;;;;;3569;172;5;3574
550;3542;202;1;3543;;;;;;;;3575;188;0;3575
551;3561;192;3;3564;;;;;;;;3573;157;2;3575
552;3655;188;3;3658;;;;;;;;3573;166;2;3575
553;3541;185;3;3544;;;;;;;;3573;175;2;3575
554;3556;168;2;3558;;;;;;;;3573;192;2;3575
555;3585;192;2;3587;;;;;;;;3572;171;3;3575
556;3549;197;3;3552;;;;;;;;3572;184;3;3575
557;3530;177;2;3532;;;;;;;;3571;153;4;3575
558;3507;167;2;3509;;;;;;;;3574;155;2;3576
559;3439;162;1;3440;;;;;;;;3574;178;2;3576
560;3554;189;3;3557;;;;;;;;3574;183;2;3576
561;3589;177;1;3590;;;;;;;;3574;191;2;3576
562;3565;196;2;3567;;;;;;;;3573;180;3;3576
563;3604;176;3;3607;;;;;;;;3571;159;5;3576
564;3563;186;1;3564;;;;;;;;3569;200;7;3576
565;3528;182;2;3530;;;;;;;;3577;176;0;3577
566;3560;162;2;3562;;;;;;;;3576;186;1;3577
567;3504;185;2;3506;;;;;;;;3576;187;1;3577
568;3538;166;3;3541;;;;;;;;3575;178;2;3577
569;3615;172;2;3617;;;;;;;;3575;187;2;3577
570;3532;176;4;3536;;;;;;;;3575;209;2;3577
571;3571;159;5;3576;;;;;;;;3574;164;3;3577
572;3622;178;3;3625;;;;;;;;3574;179;3;3577
573;3600;180;4;3604;;;;;;;;3573;169;4;3577
574;3578;157;3;3581;;;;;;;;3572;180;5;3577
575;3469;166;3;3472;;;;;;;;3572;189;5;3577
576;3509;186;3;3512;;;;;;;;3571;171;6;3577
577;3621;172;3;3624;;;;;;;;3570;186;7;3577
578;3565;188;5;3570;;;;;;;;3578;184;0;3578
579;3501;165;5;3506;;;;;;;;3577;160;1;3578
580;3566;171;6;3572;;;;;;;;3575;187;3;3578
581;3598;187;3;3601;;;;;;;;3575;189;3;3578
582;3481;182;5;3486;;;;;;;;3577;179;2;3579
583;3605;181;4;3609;;;;;;;;3575;177;4;3579
584;3559;180;5;3564;;;;;;;;3575;183;4;3579
585;3593;180;3;3596;;;;;;;;3580;177;0;3580
586;3426;170;4;3430;;;;;;;;3579;188;1;3580
587;3609;171;5;3614;;;;;;;;3578;169;2;3580
588;3497;168;7;3504;;;;;;;;3578;180;2;3580
589;3571;188;2;3573;;;;;;;;3577;154;3;3580
590;3569;173;4;3573;;;;;;;;3577;163;3;3580
591;3519;188;2;3521;;;;;;;;3576;177;4;3580
592;3571;171;6;3577;;;;;;;;3576;200;4;3580
593;3558;168;3;3561;;;;;;;;3581;160;0;3581
594;3463;156;3;3466;;;;;;;;3581;198;0;3581
595;3515;187;2;3517;;;;;;;;3580;210;1;3581
596;3601;188;3;3604;;;;;;;;3579;164;2;3581
597;3568;174;2;3570;;;;;;;;3579;180;2;3581
598;3557;177;1;3558;;;;;;;;3578;157;3;3581
599;3569;187;3;3572;;;;;;;;3578;175;3;3581
600;3583;179;2;3585;;;;;;;;3578;180;3;3581
601;3542;202;4;3546;;;;;;;;3578;183;3;3581
602;3527;205;2;3529;;;;;;;;3581;183;1;3582
603;3598;150;2;3600;;;;;;;;3580;176;2;3582
604;3570;170;2;3572;;;;;;;;3578;176;4;3582
605;3576;187;1;3577;;;;;;;;3577;174;5;3582
606;3478;196;3;3481;;;;;;;;3582;182;1;3583
607;3611;210;2;3613;;;;;;;;3581;189;2;3583
608;3668;211;2;3670;;;;;;;;3580;162;3;3583
609;3609;154;3;3612;;;;;;;;3580;194;3;3583
610;3481;190;1;3482;;;;;;;;3578;181;5;3583
611;3572;171;3;3575;;;;;;;;3578;189;5;3583
612;3585;184;4;3589;;;;;;;;3582;172;2;3584
613;3632;218;4;3636;;;;;;;;3582;181;2;3584
614;3520;166;4;3524;;;;;;;;3582;192;2;3584
615;3531;169;0;3531;;;;;;;;3581;173;3;3584
616;3557;177;2;3559;;;;;;;;3581;176;3;3584
617;3548;188;1;3549;;;;;;;;3580;188;4;3584
618;3578;169;2;3580;;;;;;;;3579;196;5;3584
619;3616;180;2;3618;;;;;;;;3578;189;6;3584
620;3512;168;8;3520;;;;;;;;3577;187;7;3584
621;3492;166;5;3497;;;;;;;;3584;170;1;3585
622;3658;209;1;3659;;;;;;;;3584;186;1;3585
623;3575;209;2;3577;;;;;;;;3583;169;2;3585
624;3542;169;6;3548;;;;;;;;3583;179;2;3585
625;3509;182;5;3514;;;;;;;;3583;188;2;3585
626;3543;171;3;3546;;;;;;;;3582;187;3;3585
627;3514;197;1;3515;;;;;;;;3582;187;3;3585
628;3573;157;2;3575;;;;;;;;3584;178;2;3586
629;3473;166;3;3476;;;;;;;;3583;162;3;3586
630;3573;194;1;3574;;;;;;;;3582;208;4;3586
631;3609;170;1;3610;;;;;;;;3578;153;8;3586
632;3544;182;6;3550;;;;;;;;3586;160;1;3587
633;3583;162;3;3586;;;;;;;;3586;185;1;3587
634;3559;175;1;3560;;;;;;;;3585;161;2;3587
635;3543;185;3;3546;;;;;;;;3585;186;2;3587
636;3477;191;1;3478;;;;;;;;3585;192;2;3587
637;3610;183;0;3610;;;;;;;;3585;194;2;3587
638;3616;176;6;3622;;;;;;;;3583;184;4;3587
639;3619;153;4;3623;;;;;;;;3583;186;4;3587
640;3563;199;3;3566;;;;;;;;3582;183;5;3587
641;3569;175;3;3572;;;;;;;;3582;184;5;3587
642;3495;150;1;3496;;;;;;;;3582;194;5;3587
643;3673;201;4;3677;;;;;;;;3581;186;6;3587
644;3575;177;4;3579;;;;;;;;3588;173;0;3588
645;3645;180;1;3646;;;;;;;;3587;150;1;3588
646;3617;176;3;3620;;;;;;;;3587;170;1;3588
647;3611;170;2;3613;;;;;;;;3584;163;4;3588
648;3570;183;2;3572;;;;;;;;3588;189;1;3589
649;3469;175;3;3472;;;;;;;;3587;161;2;3589
650;3653;212;2;3655;;;;;;;;3587;179;2;3589
651;3578;189;6;3584;;;;;;;;3587;185;2;3589
652;3570;188;3;3573;;;;;;;;3587;209;2;3589
653;3591;208;1;3592;;;;;;;;3586;195;3;3589
654;3619;182;3;3622;;;;;;;;3585;184;4;3589
655;3593;162;1;3594;;;;;;;;3584;190;5;3589
656;3697;187;2;3699;;;;;;;;3590;183;0;3590
657;3705;174;3;3708;;;;;;;;3589;168;1;3590
658;3590;166;3;3593;;;;;;;;3589;177;1;3590
659;3565;178;3;3568;;;;;;;;3588;168;2;3590
660;3660;184;4;3664;;;;;;;;3586;168;4;3590
661;3496;169;2;3498;;;;;;;;3586;172;4;3590
662;3511;157;3;3514;;;;;;;;3586;190;4;3590
663;3538;186;3;3541;;;;;;;;3586;196;4;3590
664;3595;178;5;3600;;;;;;;;3591;173;0;3591
665;3624;200;7;3631;;;;;;;;3590;171;1;3591
666;3574;178;2;3576;;;;;;;;3590;176;1;3591
667;3565;167;5;3570;;;;;;;;3589;167;2;3591
668;3614;178;5;3619;;;;;;;;3588;194;3;3591
669;3689;200;7;3696;;;;;;;;3588;200;3;3591
670;3535;151;2;3537;;;;;;;;3587;188;4;3591
671;3529;170;7;3536;;;;;;;;3587;190;4;3591
672;3582;208;4;3586;;;;;;;;3586;180;5;3591
673;3411;197;5;3416;;;;;;;;3586;207;5;3591
674;3460;176;1;3461;;;;;;;;3591;208;1;3592
675;3595;200;3;3598;;;;;;;;3590;168;2;3592
676;3538;182;3;3541;;;;;;;;3590;171;2;3592
677;3576;200;4;3580;;;;;;;;3590;193;2;3592
678;3569;193;2;3571;;;;;;;;3589;179;3;3592
679;3630;194;5;3635;;;;;;;;3588;177;4;3592
680;3485;185;2;3487;;;;;;;;3588;189;4;3592
681;3597;174;3;3600;;;;;;;;3586;187;6;3592
682;3618;173;0;3618;;;;;;;;3581;194;11;3592
683;3556;171;4;3560;;;;;;;;3592;198;1;3593
684;3523;192;3;3526;;;;;;;;3590;166;3;3593
685;3550;181;2;3552;;;;;;;;3590;174;3;3593
686;3490;180;2;3492;;;;;;;;3590;181;3;3593
687;3646;163;5;3651;;;;;;;;3586;168;7;3593
688;3530;163;3;3533;;;;;;;;3594;213;0;3594
689;3592;197;5;3597;;;;;;;;3593;162;1;3594
690;3546;170;2;3548;;;;;;;;3590;185;4;3594
691;3614;196;5;3619;;;;;;;;3590;188;4;3594
692;3545;170;3;3548;;;;;;;;3589;187;5;3594
693;3453;189;8;3461;;;;;;;;3587;188;7;3594
694;3515;173;2;3517;;;;;;;;3594;189;1;3595
695;3536;163;6;3542;;;;;;;;3594;200;1;3595
696;3648;185;3;3651;;;;;;;;3593;176;2;3595
697;3534;200;4;3538;;;;;;;;3593;188;2;3595
698;3625;195;4;3629;;;;;;;;3592;171;3;3595
699;3624;199;1;3625;;;;;;;;3590;186;5;3595
700;3529;197;3;3532;;;;;;;;3590;188;5;3595
701;3615;177;5;3620;;;;;;;;3590;198;5;3595
702;3564;187;2;3566;;;;;;;;3590;216;5;3595
703;3450;162;3;3453;;;;;;;;3595;171;1;3596
704;3519;198;2;3521;;;;;;;;3594;167;2;3596
705;3536;173;3;3539;;;;;;;;3594;169;2;3596
706;3586;168;7;3593;;;;;;;;3593;180;3;3596
707;3624;189;4;3628;;;;;;;;3592;169;4;3596
708;3640;160;2;3642;;;;;;;;3591;177;5;3596
709;3551;195;4;3555;;;;;;;;3591;183;5;3596
710;3427;166;7;3434;;;;;;;;3590;182;6;3596
711;3595;170;4;3599;;;;;;;;3589;191;7;3596
712;3615;192;7;3622;;;;;;;;3596;177;1;3597
713;3569;172;5;3574;;;;;;;;3595;187;2;3597
714;3546;180;6;3552;;;;;;;;3594;173;3;3597
715;3673;181;1;3674;;;;;;;;3594;197;3;3597
716;3587;179;2;3589;;;;;;;;3593;187;4;3597
717;3655;174;4;3659;;;;;;;;3592;176;5;3597
718;3553;171;2;3555;;;;;;;;3592;191;5;3597
719;3661;188;2;3663;;;;;;;;3592;196;5;3597
720;3513;205;1;3514;;;;;;;;3592;197;5;3597
721;3634;196;2;3636;;;;;;;;3591;174;6;3597
722;3544;166;2;3546;;;;;;;;3597;196;1;3598
723;3658;175;1;3659;;;;;;;;3595;200;3;3598
724;3590;185;4;3594;;;;;;;;3594;173;4;3598
725;3607;198;1;3608;;;;;;;;3594;182;4;3598
726;3592;169;4;3596;;;;;;;;3594;188;4;3598
727;3694;181;6;3700;;;;;;;;3597;181;2;3599
728;3551;210;2;3553;;;;;;;;3597;181;2;3599
729;3536;191;1;3537;;;;;;;;3597;189;2;3599
730;3626;217;3;3629;;;;;;;;3595;170;4;3599
731;3579;164;2;3581;;;;;;;;3595;221;4;3599
732;3459;151;4;3463;;;;;;;;3592;180;7;3599
733;3594;182;4;3598;;;;;;;;3600;165;0;3600
734;3613;181;3;3616;;;;;;;;3598;150;2;3600
735;3532;180;2;3534;;;;;;;;3597;174;3;3600
736;3526;183;2;3528;;;;;;;;3597;188;3;3600
737;3637;199;2;3639;;;;;;;;3595;178;5;3600
738;3594;213;0;3594;;;;;;;;3601;180;0;3601
739;3567;156;2;3569;;;;;;;;3600;167;1;3601
740;3638;211;2;3640;;;;;;;;3600;174;1;3601
741;3586;196;4;3590;;;;;;;;3599;185;2;3601
742;3502;192;5;3507;;;;;;;;3598;187;3;3601
743;3518;174;4;3522;;;;;;;;3597;175;4;3601
744;3540;186;6;3546;;;;;;;;3599;174;3;3602
745;3448;163;3;3451;;;;;;;;3599;208;3;3602
746;3552;177;1;3553;;;;;;;;3597;201;5;3602
747;3596;177;1;3597;;;;;;;;3602;189;1;3603
748;3565;190;1;3566;;;;;;;;3599;182;4;3603
749;3549;182;5;3554;;;;;;;;3599;183;4;3603
750;3513;176;2;3515;;;;;;;;3599;195;4;3603
751;3567;161;2;3569;;;;;;;;3599;197;4;3603
752;3423;163;2;3425;;;;;;;;3599;213;4;3603
753;3463;179;2;3465;;;;;;;;3597;172;6;3603
754;3559;163;3;3562;;;;;;;;3603;162;1;3604
755;3672;182;5;3677;;;;;;;;3602;190;2;3604
756;3494;179;4;3498;;;;;;;;3602;206;2;3604
757;3603;175;3;3606;;;;;;;;3601;188;3;3604
758;3608;178;2;3610;;;;;;;;3601;199;3;3604
759;3582;192;2;3584;;;;;;;;3600;180;4;3604
760;3496;188;6;3502;;;;;;;;3599;171;5;3604
761;3631;193;3;3634;;;;;;;;3604;191;1;3605
762;3484;193;4;3488;;;;;;;;3603;183;2;3605
763;3590;216;5;3595;;;;;;;;3602;169;3;3605
764;3486;178;4;3490;;;;;;;;3601;166;4;3605
765;3597;175;4;3601;;;;;;;;3605;170;1;3606
766;3575;178;2;3577;;;;;;;;3604;169;2;3606
767;3558;194;1;3559;;;;;;;;3604;184;2;3606
768;3582;194;5;3587;;;;;;;;3603;175;3;3606
769;3559;171;1;3560;;;;;;;;3605;183;2;3607
770;3480;154;0;3480;;;;;;;;3604;176;3;3607
771;3563;180;5;3568;;;;;;;;3603;180;4;3607
772;3505;153;2;3507;;;;;;;;3603;181;4;3607
773;3549;168;2;3551;;;;;;;;3602;176;5;3607
774;3578;184;0;3578;;;;;;;;3600;198;7;3607
775;3580;210;1;3581;;;;;;;;3607;198;1;3608
776;3473;180;7;3480;;;;;;;;3606;196;2;3608
777;3581;173;3;3584;;;;;;;;3608;226;1;3609
778;3621;194;1;3622;;;;;;;;3606;172;3;3609
779;3545;182;4;3549;;;;;;;;3605;181;4;3609
780;3590;193;2;3592;;;;;;;;3604;193;5;3609
781;3641;179;4;3645;;;;;;;;3610;183;0;3610
782;3462;171;1;3463;;;;;;;;3609;170;1;3610
783;3479;177;0;3479;;;;;;;;3608;178;2;3610
784;3601;166;4;3605;;;;;;;;3608;185;2;3610
785;3557;195;3;3560;;;;;;;;3606;172;4;3610
786;3581;189;2;3583;;;;;;;;3606;201;4;3610
787;3443;204;3;3446;;;;;;;;3609;183;2;3611
788;3553;203;2;3555;;;;;;;;3607;210;4;3611
789;3592;198;1;3593;;;;;;;;3606;148;5;3611
790;3499;169;2;3501;;;;;;;;3605;174;6;3611
791;3572;189;5;3577;;;;;;;;3612;180;0;3612
792;3525;201;1;3526;;;;;;;;3611;165;1;3612
793;3588;189;4;3592;;;;;;;;3609;154;3;3612
794;3654;193;3;3657;;;;;;;;3609;179;3;3612
795;3497;176;1;3498;;;;;;;;3608;198;4;3612
796;3529;194;3;3532;;;;;;;;3611;170;2;3613
797;3533;198;7;3540;;;;;;;;3611;198;2;3613
798;3545;195;5;3550;;;;;;;;3611;210;2;3613
799;3698;176;4;3702;;;;;;;;3610;183;3;3613
800;3550;175;5;3555;;;;;;;;3606;199;7;3613
801;3567;203;3;3570;;;;;;;;3613;162;1;3614
802;3520;166;4;3524;;;;;;;;3612;172;2;3614
803;3553;158;1;3554;;;;;;;;3612;185;2;3614
804;3525;161;5;3530;;;;;;;;3611;193;3;3614
805;3492;160;4;3496;;;;;;;;3609;165;5;3614
806;3558;196;4;3562;;;;;;;;3609;171;5;3614
807;3668;203;4;3672;;;;;;;;3613;171;2;3615
808;3599;174;3;3602;;;;;;;;3612;181;3;3615
809;3621;186;4;3625;;;;;;;;3611;184;4;3615
810;3595;187;2;3597;;;;;;;;3609;177;6;3615
811;3579;188;1;3580;;;;;;;;3615;177;1;3616
812;3612;172;2;3614;;;;;;;;3613;181;3;3616
813;3563;204;2;3565;;;;;;;;3609;196;7;3616
814;3591;174;6;3597;;;;;;;;3616;173;1;3617
815;3468;177;0;3468;;;;;;;;3615;172;2;3617
816;3585;194;2;3587;;;;;;;;3614;163;3;3617
817;3661;212;2;3663;;;;;;;;3613;182;4;3617
818;3500;183;2;3502;;;;;;;;3612;177;5;3617
819;3513;174;3;3516;;;;;;;;3618;173;0;3618
820;3604;169;2;3606;;;;;;;;3617;200;1;3618
821;3581;160;0;3581;;;;;;;;3616;180;2;3618
822;3599;197;4;3603;;;;;;;;3616;196;2;3618
823;3684;166;1;3685;;;;;;;;3615;210;3;3618
824;3490;163;1;3491;;;;;;;;3614;183;4;3618
825;3628;162;4;3632;;;;;;;;3619;196;0;3619
826;3646;184;2;3648;;;;;;;;3618;170;1;3619
827;3465;161;8;3473;;;;;;;;3618;183;1;3619
828;3618;152;3;3621;;;;;;;;3618;203;1;3619
829;3534;182;5;3539;;;;;;;;3617;195;2;3619
830;3515;170;2;3517;;;;;;;;3616;187;3;3619
831;3545;174;4;3549;;;;;;;;3614;178;5;3619
832;3501;165;0;3501;;;;;;;;3614;196;5;3619
833;3619;185;3;3622;;;;;;;;3617;176;3;3620
834;3587;185;2;3589;;;;;;;;3616;190;4;3620
835;3525;180;5;3530;;;;;;;;3616;192;4;3620
836;3611;193;3;3614;;;;;;;;3615;177;5;3620
837;3552;158;2;3554;;;;;;;;3619;179;2;3621
838;3655;177;1;3656;;;;;;;;3618;152;3;3621
839;3635;172;4;3639;;;;;;;;3618;189;3;3621
840;3498;145;0;3498;;;;;;;;3621;191;1;3622
841;3605;174;6;3611;;;;;;;;3621;194;1;3622
842;3507;164;5;3512;;;;;;;;3619;182;3;3622
843;3543;169;3;3546;;;;;;;;3619;185;3;3622
844;3590;198;5;3595;;;;;;;;3616;176;6;3622
845;3527;174;5;3532;;;;;;;;3615;192;7;3622
846;3651;163;1;3652;;;;;;;;3621;178;2;3623
847;3618;195;5;3623;;;;;;;;3621;195;2;3623
848;3557;178;2;3559;;;;;;;;3619;153;4;3623
849;3702;181;0;3702;;;;;;;;3618;195;5;3623
850;3629;195;4;3633;;;;;;;;3622;190;2;3624
851;3531;159;1;3532;;;;;;;;3621;172;3;3624
852;3542;181;3;3545;;;;;;;;3620;181;4;3624
853;3632;175;4;3636;;;;;;;;3620;182;4;3624
854;3527;169;2;3529;;;;;;;;3618;202;6;3624
855;3597;201;5;3602;;;;;;;;3624;199;1;3625
856;3569;189;3;3572;;;;;;;;3623;167;2;3625
857;3554;206;1;3555;;;;;;;;3622;178;3;3625
858;3603;162;1;3604;;;;;;;;3622;179;3;3625
859;3545;192;3;3548;;;;;;;;3621;186;4;3625
860;3567;166;3;3570;;;;;;;;3620;188;5;3625
861;3609;165;5;3614;;;;;;;;3621;189;5;3626
862;3491;199;5;3496;;;;;;;;3619;178;7;3626
863;3594;188;4;3598;;;;;;;;3627;169;0;3627
864;3627;169;0;3627;;;;;;;;3625;197;2;3627
865;3537;190;4;3541;;;;;;;;3624;175;3;3627
866;3399;167;6;3405;;;;;;;;3624;191;3;3627
867;3661;171;1;3662;;;;;;;;3620;178;7;3627
868;3561;156;3;3564;;;;;;;;3626;183;2;3628
869;3476;194;4;3480;;;;;;;;3624;189;4;3628
870;3590;188;5;3595;;;;;;;;3624;193;4;3628
871;3677;173;4;3681;;;;;;;;3628;194;1;3629
872;3625;197;2;3627;;;;;;;;3626;217;3;3629
873;3756;198;5;3761;;;;;;;;3625;195;4;3629
874;3565;171;6;3571;;;;;;;;3629;172;1;3630
875;3631;191;2;3633;;;;;;;;3629;173;1;3630
876;3603;181;4;3607;;;;;;;;3629;183;1;3630
877;3604;191;1;3605;;;;;;;;3624;200;7;3631
878;3571;177;2;3573;;;;;;;;3631;154;1;3632
879;3588;200;3;3591;;;;;;;;3628;162;4;3632
880;3607;210;4;3611;;;;;;;;3627;175;5;3632
881;3581;183;1;3582;;;;;;;;3627;197;5;3632
882;3617;200;1;3618;;;;;;;;3631;181;2;3633
883;3580;177;0;3580;;;;;;;;3631;191;2;3633
884;3636;184;1;3637;;;;;;;;3631;193;2;3633
885;3534;189;3;3537;;;;;;;;3631;209;2;3633
886;3592;176;5;3597;;;;;;;;3629;195;4;3633
887;3584;190;5;3589;;;;;;;;3629;211;4;3633
888;3465;181;2;3467;;;;;;;;3633;189;1;3634
889;3595;221;4;3599;;;;;;;;3631;193;3;3634
890;3588;194;3;3591;;;;;;;;3628;201;6;3634
891;3624;175;3;3627;;;;;;;;3633;181;2;3635
892;3525;170;3;3528;;;;;;;;3633;191;2;3635
893;3563;184;8;3571;;;;;;;;3630;194;5;3635
894;3503;176;4;3507;;;;;;;;3629;204;6;3635
895;3581;176;3;3584;;;;;;;;3634;196;2;3636
896;3514;182;1;3515;;;;;;;;3633;188;3;3636
897;3538;158;3;3541;;;;;;;;3632;175;4;3636
898;3554;185;2;3556;;;;;;;;3632;195;4;3636
899;3660;203;1;3661;;;;;;;;3632;218;4;3636
900;3590;168;2;3592;;;;;;;;3636;184;1;3637
901;3621;178;2;3623;;;;;;;;3630;205;7;3637
902;3588;168;2;3590;;;;;;;;3632;195;6;3638
903;3594;173;3;3597;;;;;;;;3637;181;2;3639
904;3545;190;0;3545;;;;;;;;3637;199;2;3639
905;3474;169;7;3481;;;;;;;;3635;172;4;3639
906;3539;186;1;3540;;;;;;;;3633;193;6;3639
907;3633;189;1;3634;;;;;;;;3638;211;2;3640
908;3577;154;3;3580;;;;;;;;3636;174;4;3640
909;3536;186;2;3538;;;;;;;;3639;174;2;3641
910;3553;189;3;3556;;;;;;;;3638;175;3;3641
911;3627;197;5;3632;;;;;;;;3641;183;1;3642
912;3618;202;6;3624;;;;;;;;3640;160;2;3642
913;3560;171;1;3561;;;;;;;;3640;168;2;3642
914;3621;191;1;3622;;;;;;;;3635;211;7;3642
915;3549;177;2;3551;;;;;;;;3643;176;2;3645
916;3559;178;5;3564;;;;;;;;3641;179;4;3645
917;3631;193;2;3633;;;;;;;;3640;184;5;3645
918;3594;169;2;3596;;;;;;;;3645;180;1;3646
919;3444;168;3;3447;;;;;;;;3643;169;3;3646
920;3548;166;3;3551;;;;;;;;3642;180;4;3646
921;3564;177;2;3566;;;;;;;;3646;184;2;3648
922;3659;159;6;3665;;;;;;;;3642;204;6;3648
923;3642;204;6;3648;;;;;;;;3646;210;3;3649
924;3458;177;4;3462;;;;;;;;3646;215;3;3649
925;3616;187;3;3619;;;;;;;;3648;166;2;3650
926;3599;195;4;3603;;;;;;;;3645;180;5;3650
927;3570;175;1;3571;;;;;;;;3650;197;1;3651
928;3505;158;0;3505;;;;;;;;3648;185;3;3651
929;3594;189;1;3595;;;;;;;;3646;163;5;3651
930;3659;173;1;3660;;;;;;;;3651;163;1;3652
931;3578;175;3;3581;;;;;;;;3651;194;1;3652
932;3557;170;9;3566;;;;;;;;3650;192;3;3653
933;3551;200;0;3551;;;;;;;;3651;191;3;3654
934;3667;165;2;3669;;;;;;;;3654;198;1;3655
935;3512;180;1;3513;;;;;;;;3653;212;2;3655
936;3540;172;1;3541;;;;;;;;3655;177;1;3656
937;3572;180;5;3577;;;;;;;;3651;191;5;3656
938;3593;176;2;3595;;;;;;;;3651;208;5;3656
939;3680;226;5;3685;;;;;;;;3654;193;3;3657
940;3533;176;3;3536;;;;;;;;3655;188;3;3658
941;3519;173;1;3520;;;;;;;;3655;193;3;3658
942;3615;177;1;3616;;;;;;;;3658;175;1;3659
943;3566;197;6;3572;;;;;;;;3658;209;1;3659
944;3582;183;5;3587;;;;;;;;3655;174;4;3659
945;3533;196;5;3538;;;;;;;;3659;173;1;3660
946;3629;183;1;3630;;;;;;;;3657;200;3;3660
947;3561;168;2;3563;;;;;;;;3654;164;6;3660
948;3568;180;1;3569;;;;;;;;3660;186;1;3661
949;3594;173;4;3598;;;;;;;;3660;203;1;3661
950;3555;180;6;3561;;;;;;;;3661;171;1;3662
951;3532;163;6;3538;;;;;;;;3658;154;4;3662
952;3572;179;2;3574;;;;;;;;3657;177;5;3662
953;3646;210;3;3649;;;;;;;;3657;200;5;3662
954;3514;182;1;3515;;;;;;;;3661;188;2;3663
955;3490;180;4;3494;;;;;;;;3661;212;2;3663
956;3529;179;3;3532;;;;;;;;3659;182;4;3663
957;3566;167;1;3567;;;;;;;;3659;194;4;3663
958;3556;192;3;3559;;;;;;;;3663;187;1;3664
959;3524;156;2;3526;;;;;;;;3660;184;4;3664
960;3611;165;1;3612;;;;;;;;3662;192;3;3665
961;3521;192;2;3523;;;;;;;;3661;195;4;3665
962;3620;188;5;3625;;;;;;;;3659;159;6;3665
963;3570;188;2;3572;;;;;;;;3664;172;3;3667
964;3491;166;2;3493;;;;;;;;3666;169;2;3668
965;3527;196;2;3529;;;;;;;;3665;166;3;3668
966;3549;166;5;3554;;;;;;;;3665;202;3;3668
967;3592;196;5;3597;;;;;;;;3667;165;2;3669
968;3663;187;1;3664;;;;;;;;3667;173;2;3669
969;3577;163;3;3580;;;;;;;;3668;211;2;3670
970;3536;186;4;3540;;;;;;;;3670;154;1;3671
971;3520;177;1;3521;;;;;;;;3668;203;4;3672
972;3600;198;7;3607;;;;;;;;3673;181;1;3674
973;3628;201;6;3634;;;;;;;;3672;184;4;3676
974;3540;191;4;3544;;;;;;;;3671;183;5;3676
975;3627;175;5;3632;;;;;;;;3673;201;4;3677
976;3527;190;5;3532;;;;;;;;3672;182;5;3677
977;3516;175;2;3518;;;;;;;;3672;217;5;3677
978;3456;172;0;3456;;;;;;;;3676;190;2;3678
979;3558;172;3;3561;;;;;;;;3676;176;3;3679
980;3496;196;3;3499;;;;;;;;3676;198;3;3679
981;3560;192;4;3564;;;;;;;;3677;181;3;3680
982;3547;179;1;3548;;;;;;;;3677;173;4;3681
983;3672;217;5;3677;;;;;;;;3684;166;1;3685
984;3619;179;2;3621;;;;;;;;3680;226;5;3685
985;3582;182;1;3583;;;;;;;;3686;165;3;3689
986;3509;183;7;3516;;;;;;;;3689;200;7;3696
987;3618;183;1;3619;;;;;;;;3697;187;2;3699
988;3522;173;1;3523;;;;;;;;3694;181;6;3700
989;3485;173;4;3489;;;;;;;;3702;181;0;3702
990;3586;190;4;3590;;;;;;;;3698;176;4;3702
991;3469;156;2;3471;;;;;;;;3705;174;3;3708
992;3494;185;3;3497;;;;;;;;3701;197;8;3709
993;3536;162;4;3540;;;;;;;;3712;184;0;3712
994;3597;172;6;3603;;;;;;;;3719;179;3;3722
995;3532;184;4;3536;;;;;;;;3729;191;2;3731
996;3461;159;2;3463;;;;;;;;3752;193;1;3753
997;3586;207;5;3591;;;;;;;;3756;198;5;3761
998;3574;191;2;3576;;;;;;;;3772;168;1;3773
999;3651;191;5;3656;;;;;;;;3809;232;5;3814
